11111111111111111
10P000001100000E1
10000000000000001
1000000C000000001
11111111111111111